{
  "H4": 2,
  "H0": 1,
  "H6": 2,
  "H3": 1,
  "H1": 1,
  "H7": 2,
  "H9": 2,
  "H2": 1,
  "H8": 2,
  "H5": 2
}